BVRRBVRRBVVBRRR
RRBRVVBVVBBRBRV
VVBRBVBRBVRBBVR
BVRRBVRRBVVRRBB
VVVVVBBRBVRRBVR
BVRBBBVRRVRBBBB
RRRRRRVBBRVBBRV
RBVRBVRBBVRRBBV
VRBVBBVRRVBBRVB
RBVBVBRBBBBBRVR