RVBBRVBRVRBBVRB
VRBVRBVVBRVRVBB
VVBVRBVVRBRRVVB
VRBVRRBRBBRBRRR
VRBVRVRBBBRVRVR
RVRRRRBVRBBRBBR
RVBVRBVVBRBRRRB
RBVRBBBVRVRBRBV
RBVRVBRVBRVBRRB
VRVVRBBVRVBBRRB