BBBBBBBBBBBBBBB
VVVBBBVVVBBBVVV
RRVRBRVRVRBRVRR
VVVBBBVVVBBBVVV
BBBBBBBBBBBBBBB
RVRVRVRVRVRVRVR
RRVRVRVRVRVRVRR
BBBVVVVBVVVVBBB
BBRRRRVBRRRRRBB
BVVVVVVBVVVVVVB

