RRRRRRRRRRRRRRR
RRRRRBBBBBRRRRR
RRRBBBVBVBBBRRR
RRBBVVVBVVVBBRR
RRBVVBBBBBVVBRR
RRBVVBBBBBVVBRR
RRBBVVVBVVVBBRR
RRRBBBVBVBBBRRR
RRRRRBBBBBRRRRR
RRRRRRRRRRRRRRR